Seat No,AFM,FAA,COM,BECO,ADVT,FC,B LAW,Total
15001,93,96,80,82,82,79,71,583
15002,48,51,55,44,59,61,40,358
15003,91,78,68,47,72,62,57,475
15004,63,67,55,49,66,53,58,411
15005,0,0,0,0,0,0,0,0
15006,69,48,0,45,59,48,51,320
15007,77,42,55,62,68,62,53,419
15008,71,49,58,47,57,65,57,404
15009,67,57,57,58,72,71,58,440
15010,50,55,49,40,60,67,47,368
15011,44,50,51,42,57,66,40,350
15012,73,65,61,54,71,75,69,468
15013,43,56,43,40,40,64,40,326
15014,86,68,51,46,41,62,43,397
15015,45,40,40,21,40,47,14,247
15016,71,53,54,66,60,72,71,447
15017,72,64,54,52,67,74,69,452
15018,76,56,57,40,69,57,59,414
15019,89,69,62,72,63,67,63,485
15020,43,50,40,40,40,54,24,291
15021,55,49,46,68,55,60,55,388
15022,75,64,40,56,59,71,48,413
15023,28,22,40,44,57,21,40,252
15024,75,89,59,66,72,77,62,500
15025,40,40,40,21,48,46,26,261
15026,50,48,42,42,54,56,45,337
15027,66,50,50,63,62,58,49,398
15028,40,40,40,45,54,59,40,318
15029,57,40,40,14,43,0,4,198
15030,72,61,41,40,51,59,21,345
15031,47,71,43,43,53,62,40,359
15032,83,60,44,40,45,47,40,359
15033,66,65,41,55,70,59,42,398
15034,79,73,49,56,72,72,64,465
15035,40,40,40,18,42,57,13,250
15036,84,80,57,58,67,67,61,474
15037,64,66,49,52,56,57,43,387
15038,61,75,52,55,71,59,41,414
15039,75,54,52,40,59,62,53,395
15040,72,82,53,51,43,53,45,399
15041,20,40,26,24,40,61,2,213
15042,87,69,60,54,66,67,77,480
15043,45,62,54,46,56,69,47,379
15044,86,79,56,42,52,59,41,415
15045,89,45,44,44,56,66,57,401
15046,76,47,63,61,75,76,60,458
15047,56,52,42,41,56,58,47,352
15048,40,40,41,25,40,57,40,283
15049,40,40,40,40,52,45,40,297
15050,83,46,46,42,54,53,53,377
15051,83,76,58,44,71,69,68,469
15052,77,45,52,41,56,65,43,379
15053,61,73,40,40,43,58,40,355
15054,80,63,40,40,42,50,40,355
15055,40,40,40,0,0,56,0,176
15056,73,72,57,40,53,46,53,394
15057,57,73,41,40,53,53,55,372
15058,40,40,40,16,47,56,40,279
15059,40,40,44,40,51,69,40,324
15060,92,69,57,60,75,73,53,479
15061,0,0,0,0,0,0,0,0
15062,76,68,42,52,52,57,28,375
15063,62,83,40,40,48,44,49,366
15064,67,64,45,61,69,53,64,423
15065,0,0,0,0,0,0,0,0
15066,67,65,54,43,66,67,55,417
15067,0,0,0,0,0,0,0,0
15068,79,74,72,78,92,79,78,552
15069,83,69,63,60,64,76,76,491
15070,40,14,40,24,28,60,5,211
15071,64,40,47,44,40,48,47,330
15072,87,67,62,48,65,49,54,432
15073,43,56,51,49,53,66,43,361
15074,40,26,40,40,41,52,6,245
15075,47,41,49,64,60,60,48,369
15076,70,57,50,53,74,63,44,411
15077,50,40,44,48,47,55,2,286
15078,49,40,52,67,70,75,40,393
15079,57,53,57,54,71,80,48,420
15080,83,65,40,49,50,54,45,386
15081,42,23,40,40,40,23,7,215
15082,40,13,8,40,20,48,26,195
15083,79,40,49,40,40,62,40,350
15084,92,69,52,53,67,52,52,437
15085,76,79,71,63,74,65,63,491
15086,40,40,45,40,57,61,40,323
15087,40,40,40,40,53,61,46,320
15088,40,40,26,7,27,61,40,241
15089,82,59,40,41,49,49,41,361
15090,62,40,49,40,53,55,40,339
15091,68,41,53,40,56,59,54,371
15092,71,50,41,43,45,54,40,344
15093,86,71,58,67,85,69,61,497
15094,66,44,41,48,59,62,40,360
15095,53,53,43,40,61,64,40,354
15096,79,65,40,40,43,62,40,369
15097,40,24,40,40,40,52,26,262
15098,81,83,61,15,84,76,70,470
15099,65,63,41,0,47,51,40,307
15100,65,79,51,48,51,54,41,389
15101,61,60,45,41,49,59,40,355
15102,61,57,47,61,57,62,40,385
15103,52,54,40,49,40,52,40,327
15104,59,61,40,53,54,57,46,370
15105,62,65,41,55,51,73,50,397
15106,74,62,48,40,43,65,49,381
15107,74,59,46,50,65,60,61,415
15108,40,23,40,15,40,50,40,248
15109,40,40,41,40,28,49,40,278
15110,43,42,40,47,51,55,40,318
15111,51,53,40,42,47,61,40,334
15112,57,66,27,46,44,64,41,345
15113,51,62,42,44,60,50,52,361
15114,23,45,40,40,57,69,40,314
15115,69,67,40,40,45,50,50,361
15116,61,77,40,40,50,53,40,361
15117,43,40,25,40,40,51,8,247
15118,44,60,40,40,47,60,40,331
15119,67,48,40,42,58,61,40,356
15120,69,46,51,44,59,59,45,373
15121,67,89,81,65,82,77,83,544
15122,68,67,61,62,57,53,44,412
15123,69,25,42,40,47,47,40,310
15124,52,40,40,23,40,39,19,253
15125,72,64,42,50,52,61,52,393
15126,74,89,55,48,72,47,50,435
15127,91,95,80,73,87,77,91,594
15128,12,40,40,40,40,41,0,213
15129,48,47,48,48,48,62,23,324
15130,0,0,40,50,57,64,1,212
15131,60,60,45,40,57,58,40,360
15132,78,73,45,51,44,61,53,405
15133,50,40,40,40,46,51,40,307
15134,71,45,42,44,53,59,52,366
15135,71,74,48,57,58,64,40,412
15136,87,85,73,71,75,72,71,534
15137,89,71,59,62,69,85,52,487
15138,48,53,40,40,40,48,40,309
15139,17,45,40,58,41,50,40,291
15140,62,40,40,41,50,69,46,348
15141,89,73,54,62,70,59,50,457
15142,85,74,60,64,66,71,64,484
15143,78,78,55,63,52,65,51,442
15144,89,82,53,51,62,78,68,483
15145,26,19,40,19,40,51,13,208
15146,40,40,23,40,41,48,2,234
15147,85,62,69,79,75,79,62,511
15148,25,40,40,40,40,60,40,285
15149,46,40,25,46,40,58,16,271
15150,63,55,40,40,40,49,45,332
15151,42,40,40,43,46,52,56,319
15152,11,13,26,17,28,48,1,144
15153,81,73,58,76,72,78,60,498
15154,5,8,40,9,25,42,2,131
15155,51,65,40,46,40,63,22,327
15156,75,78,68,51,76,81,74,503
15157,44,40,40,26,42,53,40,285
15158,65,59,40,40,46,50,23,323
15159,57,45,51,67,56,66,51,393
15160,64,40,42,54,40,75,11,326
15161,74,63,51,53,59,64,53,417
15162,58,73,53,65,55,67,57,428
15163,78,60,58,52,60,77,40,425
15164,40,52,40,22,28,54,13,249
15165,72,55,52,46,44,65,40,374
15166,73,58,48,68,61,80,55,443
15167,73,46,42,74,57,71,25,388
15168,89,85,51,81,67,78,80,531
15169,44,40,43,44,25,48,40,284
15170,40,22,23,40,23,34,23,205
15171,40,40,40,27,43,49,40,279
15172,77,70,45,54,50,69,54,419
15173,90,95,76,62,72,81,77,553
15174,95,94,58,74,57,71,53,502
15175,74,46,44,55,57,72,42,390
15176,76,61,58,75,75,74,65,484
15177,45,40,40,40,12,47,12,236
15178,40,40,40,63,51,49,40,323
15179,80,72,62,65,69,67,61,476
15180,0,0,0,0,0,0,0,0
15181,51,40,46,47,57,56,43,340
15182,49,40,40,19,40,48,40,276
15183,62,40,44,52,60,49,40,347
15184,40,40,40,42,56,70,58,346
15185,49,40,40,40,40,60,40,309
15186,27,40,40,0,0,0,0,107
15187,76,74,58,61,51,61,57,438
15188,83,87,70,71,83,77,73,544
15189,47,40,41,42,52,61,51,334
15190,24,0,40,41,42,48,40,235
15191,76,51,40,51,50,61,41,370
15192,46,40,46,41,43,60,40,316
15193,40,40,43,45,45,51,40,304
15194,40,40,40,18,40,49,40,267
15195,82,59,58,67,75,68,61,470
15196,79,78,61,74,65,62,59,478
15197,93,91,55,65,79,63,63,509
15198,80,61,40,43,42,47,45,358
15199,72,63,45,40,56,59,40,375
15200,63,65,52,49,59,48,56,392
15201,53,73,46,68,52,55,51,398
15202,47,40,49,72,44,60,40,352
15203,53,40,41,58,40,45,40,317
15204,58,52,41,57,52,51,58,369
15205,0,0,0,0,0,0,0,0
15206,72,65,53,79,63,70,55,457
15207,62,74,52,54,52,55,43,392
15208,78,80,73,86,76,76,75,544
15209,50,40,50,71,52,49,63,375
15210,68,75,52,60,44,50,45,394
15211,40,40,28,21,27,48,26,230
15212,54,45,41,49,42,40,40,311
15213,74,72,69,86,69,68,50,488
15214,67,54,40,47,40,53,49,350
15215,91,74,66,78,69,75,54,507
15216,49,67,40,58,46,52,40,352
15217,77,65,56,65,64,59,56,442
15218,0,0,0,0,0,0,0,0
15219,47,58,60,55,65,59,53,397
15220,66,63,45,46,50,53,57,380
15221,17,40,40,40,40,48,40,265
15222,17,40,40,40,40,49,25,251
15223,76,54,65,85,59,72,67,478
15224,53,50,42,51,48,53,42,339
15225,87,58,41,68,50,53,43,400
15226,0,0,0,0,0,0,0,0
15227,89,74,64,66,73,65,71,502
15228,42,69,40,54,41,65,47,358
15229,77,76,65,58,54,62,81,473
15230,87,83,56,71,65,66,50,478
15231,22,44,40,47,40,55,40,288
15232,90,63,59,77,75,71,62,497
15233,69,52,44,63,61,67,40,396
15234,83,85,73,75,84,71,82,553
15235,60,52,49,78,53,80,54,426
15236,71,40,41,49,43,72,26,342
15237,50,42,48,54,57,65,43,359
15238,65,69,51,60,62,69,58,434
15239,75,68,42,59,53,71,57,425
15240,83,55,53,69,55,74,42,431
15241,89,72,54,60,61,63,58,457
15242,74,77,49,64,59,70,54,447
15243,58,64,46,70,58,55,53,404
15244,88,63,55,56,54,67,49,432
15245,44,40,52,58,46,61,40,341
15246,66,42,42,41,40,51,41,323
15247,15,17,25,47,40,47,24,215
15248,69,72,52,62,55,65,51,426
15249,75,88,50,60,55,57,59,444
15250,70,76,74,75,63,66,44,468
15251,71,80,52,74,64,77,47,465
15252,45,40,49,75,53,70,40,372
15253,76,40,28,40,40,54,0,278
15254,51,63,48,61,45,59,40,367
15255,59,64,58,57,62,70,57,427
15256,16,25,16,40,40,53,0,190
15257,40,56,40,69,44,73,44,366
15258,62,40,54,73,62,77,64,432
15259,93,89,78,80,76,76,61,553
15260,72,84,65,59,71,71,49,471
15261,71,82,52,77,46,69,45,442
15262,54,53,40,45,44,67,40,343
15263,49,51,45,60,43,56,40,344
15264,47,47,43,56,48,57,47,345
15265,40,40,40,45,26,60,40,291
15266,65,65,40,59,48,57,52,386
15267,56,22,26,40,23,51,27,245
15268,52,71,40,53,40,73,53,382
15269,58,54,40,22,40,58,42,314
15270,80,49,44,60,55,58,46,392
15271,40,40,27,40,40,53,40,280
15272,75,72,47,65,49,67,63,438
15273,41,40,41,40,48,48,0,258
15274,40,40,40,40,40,49,20,269
15275,49,21,56,58,53,56,40,333
15276,53,40,43,58,54,72,45,365
15277,20,21,40,40,40,53,10,224
15278,40,40,40,49,40,49,40,298
15279,40,40,43,57,43,56,20,299
15280,60,40,40,51,40,66,40,337
15281,23,40,40,49,44,55,8,259
15282,45,55,40,40,42,48,40,310
15283,64,73,66,76,63,69,67,478
15284,75,77,61,57,60,62,43,435
15285,85,73,42,80,70,70,58,478
15286,58,40,48,66,68,67,64,411
15287,94,87,73,74,86,69,71,554
15288,79,60,56,76,72,77,62,482
15289,90,79,54,78,68,79,54,502
15290,40,40,40,53,42,67,40,322
15291,40,40,28,58,44,57,27,294
15292,86,85,66,77,69,84,80,547
15293,10,22,40,67,40,61,17,257
15294,62,62,47,46,44,49,63,373
15295,53,40,47,40,46,49,40,315
15296,61,41,48,56,57,65,55,383
15297,65,61,52,59,46,66,53,402
15298,71,43,44,80,69,76,65,448
15299,45,40,40,40,42,49,46,302
15300,40,15,40,56,51,56,40,298
15301,27,1,40,40,40,37,22,207
15302,67,40,41,57,56,68,51,380
15303,40,45,40,41,40,62,11,279
15304,71,59,53,55,53,67,62,420
15305,86,90,60,74,74,72,69,525
15306,44,48,41,53,59,61,54,360
15307,40,21,40,55,44,53,50,303
15308,62,62,46,48,64,60,48,390
15309,78,68,40,43,50,55,40,374
15310,78,78,65,72,76,80,82,531
15311,57,60,40,49,52,63,53,374
15312,56,40,40,57,40,51,20,304
15313,72,20,40,40,43,47,40,302
15314,83,56,51,68,69,70,60,457
15315,45,49,40,41,40,52,44,311
15316,43,40,28,40,40,37,46,274
15317,40,40,43,42,43,63,40,311
15318,40,40,40,53,47,57,47,324
15319,62,42,49,59,43,59,60,374
15320,72,46,47,69,59,62,61,416
15321,40,45,40,40,40,48,40,293
15322,40,40,40,24,29,46,40,259
15323,49,50,40,40,40,55,20,294
15324,65,70,64,51,58,64,49,421
15325,85,75,66,61,63,64,43,457
15326,78,76,53,49,50,49,53,408
15327,70,87,58,56,60,68,71,470
15328,79,47,55,54,69,66,68,438
15329,53,43,40,43,41,47,50,317
15330,61,44,44,66,54,73,59,401
15331,48,43,49,68,46,67,52,373
15332,43,69,42,40,41,59,42,336
15333,90,89,64,63,60,74,60,500
15334,85,95,76,70,66,77,77,546
15335,76,79,70,55,68,74,55,477
15336,67,52,40,41,40,45,65,350
15337,72,60,40,40,40,45,40,337
15338,70,79,56,60,68,79,58,470
15339,0,0,0,0,0,0,0,0
15340,63,62,45,45,51,54,51,371
15341,49,40,46,51,46,48,40,320
15342,71,69,60,55,65,68,40,428
15343,92,75,60,69,66,81,80,523
15344,40,22,41,40,40,47,21,251
15345,40,16,40,30,0,32,15,173
15346,48,50,42,41,44,50,40,315
15347,61,66,44,56,40,46,40,353
15348,51,55,67,78,79,60,68,458
15349,61,52,47,43,46,58,40,347
15350,64,57,41,42,40,45,46,335
15351,74,64,46,56,47,64,67,418
15352,75,59,66,65,70,63,58,456
15353,40,25,40,40,52,59,40,296
15354,85,72,55,46,57,48,64,427
15355,81,71,45,60,49,56,56,418
15356,73,40,40,46,47,56,47,349
15357,50,51,40,57,59,68,57,382
15358,73,58,56,68,57,62,75,449
15359,45,40,40,29,26,45,46,271
15360,55,56,44,55,44,62,73,389
15361,82,71,55,58,58,70,59,453
15362,76,48,60,84,60,66,65,459
15363,82,74,40,62,40,60,49,407
15364,74,62,46,52,62,63,47,406
15365,66,42,52,61,70,71,44,406
15366,83,79,63,71,68,72,75,511
15367,85,71,50,77,67,57,47,454
15368,47,42,40,20,44,54,40,287
15369,86,84,69,67,72,68,58,504
15370,57,46,41,40,40,32,8,264
15371,52,40,40,44,40,54,40,310
15372,47,59,48,68,59,58,47,386
15373,40,53,40,40,42,46,28,289
15374,45,66,49,58,54,67,45,384
15375,88,78,54,72,65,49,50,456
15376,49,43,54,53,51,49,46,345
15377,44,22,40,46,53,49,26,280
15378,51,47,40,40,40,46,15,279
15379,43,44,59,73,71,61,70,421
15380,90,61,55,76,73,64,62,481
15381,77,59,42,65,61,48,44,396
15382,42,40,40,50,40,46,2,260
15383,79,72,40,50,48,47,51,387
15384,87,73,54,61,67,53,47,442
15385,53,54,40,43,43,57,51,341
15386,47,53,43,43,52,64,50,352
15387,84,57,59,51,61,69,63,444
15388,56,40,41,51,45,31,60,324
15389,40,43,45,66,64,66,42,366
15390,74,67,52,58,59,61,49,420
15391,41,45,25,47,40,45,40,283
15392,46,56,40,40,57,50,40,329
15393,45,0,0,0,0,0,0,45
15394,40,40,40,25,27,34,40,246
15395,57,74,47,64,43,54,70,409
15396,55,65,52,59,57,67,56,411
15397,63,49,49,60,51,65,55,392
15398,83,70,49,49,54,54,57,416
15399,0,0,0,0,0,0,0,0
15400,40,40,40,51,47,56,40,314
15401,54,52,53,45,55,62,57,378
15402,40,40,40,54,45,47,19,285
15403,64,56,46,54,40,44,40,344
15404,46,65,42,64,51,65,43,376
15405,49,46,40,47,51,53,42,328
15406,57,64,61,67,61,56,56,422
15407,54,40,28,46,48,50,43,309
15408,78,75,51,65,65,66,72,472
15409,40,40,40,40,40,54,29,283
15410,41,23,41,41,40,46,22,254
15411,88,86,65,72,75,55,81,522
15412,76,69,58,47,40,57,40,387
15413,68,46,40,61,43,48,40,346
15414,54,55,49,48,54,60,40,360
15415,40,40,40,40,45,60,40,305
15416,68,59,40,40,40,51,40,338
15417,40,40,43,44,40,52,15,274
15418,24,40,40,40,29,47,7,227
15419,92,73,51,52,47,62,49,426
15420,40,59,40,53,40,53,40,325
15421,81,40,56,62,48,53,53,393
15422,71,67,43,40,40,49,40,350
15423,64,70,42,50,47,49,48,370
15424,46,66,40,61,40,44,42,339
15425,40,40,50,13,23,48,2,216
15426,56,49,46,43,42,50,40,326
15427,40,51,40,44,42,58,17,292
15428,45,50,43,44,48,53,22,305
